deviate	(verb)
engulf	(verb)
endangered	(adjective)
reptile	(noun)
divest	(verb)
delegate	(verb)
endurance	(noun)
endeavour	(verb)
junction	(noun)
harness	(verb)
archaeologist	(noun)
explicit	(adjective)
stimulate	(verb)
prosperous	(adjective)
unsurpassed	(adjective)
corruption	(noun)
disband	(verb)
scrutiny	(noun)
adorn	(verb)
magnificent	(adjective)
perseverance	(noun)
designate	(verb)
rival	(noun)
enormous	(adjective)
basin	(noun)
engrave	(verb)
inscription	(noun)
adversity	(noun)
accuse	(verb)
affair	(noun)
unpleasant	(adjective)
vague	(adjective)
campaign	(noun)
raid	(noun)
ceasefire	(noun)
dispatch	(verb)
amuse	(verb)
vital	(adjective)
incentive	(noun)