acrimony	(noun)
cacophony	(noun)
sinecure	(noun)
impede	(verb)
outweigh	(verb)
abhorrent	(adjective)
elusive	(adjective)
expensive	(adjective)
profitable	(adjective)
desultory	(adjective)
parsimonious	(adjective)
truculent	(adjective)
circumvent	(verb)
replicate	(verb)
substantial	(adjective)
paltry	(adjective)
meaningful	(adjective)
popular	(adjective)
breach	(noun)
circumnavigate	(verb)
