extirpate	(verb)
remarkable	(adjective)
pivotal	(adjective)
recondite	(adjective)
momentous	(adjective)
refuge	(noun)
gaudiness	(noun)
bedlam	(noun)
punctilious	(adjective)
vociferous	(adjective)
scathing	(adjective)
witty	(adjective)
retain	(verb)
cultivate	(verb)
immense	(adjective)
ancient	(adjective)
detritus	(noun)
refuse	(verb)
barrenness	(noun)
waggish	(adjective)
vicious	(adjective)
