lionize	(verb)
exonerate	(verb)
intractable	(adjective)
enervate	(verb)
diffident	(adjective)
lackadaisical	(adjective)
incapacitate	(verb)
hapless	(adjective)
guileless	(adjective)
duplicitous	(adjective)
listless	(adjective)
artless	(adjective)
mendacious	(adjective)
disturbing	(adjective)
unintelligible	(adjective)
esoteric	(adjective)
controversial	(adjective)
obstinate	(adjective)
streamline	(verb)
coherent	(adjective)
