uncanny	(adjective)
conciliatory	(adjective)
imprecation	(noun)
premonition	(noun)
tome	(noun)
insipid	(adjective)
satiate	(verb)
inundate	(verb)
overweening	(adjective)
expatiate	(verb)
fulsome	(adjective)
calumny	(noun)
dissemble	(verb)
convention	(noun)
eclectic	(adjective)
affinity	(noun)
lustrous	(adjective)
plasticity	(noun)
petulant	(adjective)
desultory	(adjective)
