accustomed	(adjective)
acquire	(verb)
adamant	(adjective)
adequate	(adjective)
adverse	(adjective)
amateur	(noun)
ambiguous	(adjective)
ample	(adjective)
anomaly	(noun)
antagonize	(verb)
arbitrary	(adjective)
arduous	(adjective)
assuage	(verb)
berate	(verb)
bestow	(verb)
boast	(verb)
brash	(adjective)
brusque	(adjective)
censure	(noun)
chronological	(adjective)
coalesce	(verb)
cognizant	(adjective)
cohesion	(noun)
coincide	(verb)
commitment	(noun)
conceal	(verb)
concur	(verb)
contemplate	(verb)
copious	(adjective)
corrode	(verb)
cumbersome	(adjective)
