Someone who feels achy has continuous pains in their body that are unpleasant but not very strong.	鈍痛不止的
very strange and unusual	怪誕的；罕見的；異乎尋常的
in a way that is able to be heard	可以聽到地，聽得見地
to laugh repeatedly in a quiet but uncontrolled way, often at something silly or rude or when you are nervous	（因為感到有趣、窘迫或緊張而）咯咯地笑，傻笑
a sport in which two people fight and try to throw each other to the ground	摔角運動
not loud, bright, noticeable, or obvious in any way	隱約的;暗淡的;不易察覺的，不明顯的;微妙的
a person that you have met but do not know well	相識的人，熟人;泛泛之交
an illness	小病，微恙
to talk or write about past experiences that you remember with pleasure	（對愉快的往事）追憶，回憶，緬懷
very shocked and upset	極度震驚的；極為煩亂的
calm and peaceful and without noise, violence, worry, etc.	安靜的，平靜的;安寧的
the act or process of repairing and improving something, especially a building	修復，翻新，整修（尤指建築物）
used to say you have read or been told something although you are not certain it is true	據…所知；看來；據說；聽說
a feeling of energetic interest in a particular subject or activity and an eagerness to be involved in it	巨大興趣；熱情；熱忱；熱心
a job or piece of work that is often boring or unpleasant but needs to be done regularly	日常瑣事;雜務;乏味的例行工作
great sadness felt because someone has died	哀痛;哀悼
very interesting because of being unusual or mysterious	非常有趣的;引人入勝的;神秘的
a feeling of cold	寒冷;寒意，涼意
(of something unwanted or unpleasant) about to happen soon and causing worry	（不希望或不愉快的事情）迫近的，逼近的
extremely and uncomfortably hot	熱極了，熱得難受
to live in a place or in a particular way	居住，棲身
to save goods from damage or destruction, especially from a ship that has sunk or been damaged or a building that has been damaged by fire or a flood	（尤指從失事船隻、火災或水災中）搶救，打撈
to rise extremely quickly or make extremely quick progress towards success	暴漲，飛漲
small, white pieces of dead skin from the head that collect in the hair or fall on the clothes	頭皮屑，頭屑
the number and characteristics of people who live in a particular area or form a particular group, especially in relation to their age, how much money they have and what they spend it on	人口統計資料，人口統計結果
to know about something before it happens	預見;預知;預料
something, such as a swimming pool or shopping centre, that is intended to make life more pleasant or comfortable for the people in a town, hotel, or other place	生活福利設施，便利設施；娛樂消遣設施
If a container, etc. is tamper-evident, it is designed to make it obvious if anyone has touched its contents.	是否被改動過一目了然的
the crime of getting money by deceiving people	詐騙（罪）
connected with cooking or kitchens	烹飪的;廚房的
to make someone look or feel young and energetic again	使年輕;使恢復活力;使青春煥發
a bicycle made for two people who sit one behind the other	雙人自行車
showing signs of suffering or severe anxiety	煩惱的，焦慮不安的
to imagine or expect that something will happen	預期，期望;預料
help and comfort when you are feeling sad or worried	安慰，撫慰，慰藉
relating to the universe and the natural processes that happen in it	宇宙的
the study of the movements and positions of the sun, moon, planets, and stars in the belief that they affect the character and lives of people	占星術;占星學
relating to where a person or animal was born	（人或動物）出生的
