dredge	(verb)
dwarf	(adjective)
eminent	(adjective)
carnivorous	(adjective)
ditch	(verb)
epitomize	(verb)
diplomatic	(adjective)
elongate	(verb)
mantle	(noun)
intangible	(adjective)
nostalgia	(noun)
catastrophe	(noun)
dampen	(verb)
salient	(adjective)
gulp	(verb)
pulverize	(verb)
formidable	(adjective)
accentuate	(verb)
sift	(verb)
kindle	(verb)
airborne	(adjective)
rendition	(noun)
impervious	(adjective)
extrapolate	(verb)
flock	(verb)
imprint	(verb)
foremost	(adjective)
gloom	(noun)
greasy	(adjective)
fabric	(noun)
fa√ßade	(noun)
bounteous	(adjective)
incise	(verb)
astound	(verb)
liquefy	(verb)
juvenile	(adjective)
affluent	(adjective)
ubiquitous	(adjective)
benevolent	(adjective)
humiliate	(verb)
masculine	(adjective)
