canopy	(noun)
trample	(verb)
prowl	(verb)
presage	(verb)
antecedent	(adjective)
burgeoning	(adjective)
forager	(noun)
deprivation	(noun)
parish	(noun)
vessel	(noun)
adept	(adjective)
repay	(verb)
knack	(noun)
shrinkage	(noun)
apparent	(adjective)
stratify	(verb)
latter	(adjective)
pollinator	(noun)
fungus	(noun)
imperative	(adjective)
mill	(verb)
whence	(adverb)
coerce	(verb)
dormant	(adjective)
laden	(adjective)
multitudinous	(adjective)
trivial	(adjective)
sporadic	(adjective)
sludge	(noun)
erode	(verb)
ferment	(verb)
genotype	(noun)
rarity	(noun)
misdeed	(noun)
astonishing	(adjective)
masculine	(adjective)
inflate	(verb)
proficient	(adjective)
indigenous	(adjective)
proliferation	(noun)
substantiate	(verb)
swamp	(verb)
nostalgia	(noun)
statuary	(noun)
occasional	(adjective)
bliss	(noun)
affinity	(noun)
comet	(noun)
