careful to look at or consider every part of something to make certain it is correct or safe	嚴密的，縝密的；嚴謹的
wanted by many people and usually of high quality or rare	（因品質高或稀有而）熱門的，廣受歡迎的
to ask someone for money, information, or help	請求，索求，乞求
doubting that something is true or useful	懷疑的，持懷疑態度的
to think or believe	想;認為，以為
a person who watches an activity, especially a sports event, without taking part	（尤指體育賽事的）觀眾
making you feel that something illegal is happening or that something is wrong	可疑的，引起懷疑的
When people or animals shiver, they shake slightly because they feel cold, ill, or frightened.	（因寒冷、疾病或恐懼而）輕微顫抖，發抖
to put something in a place where it is unlikely to be found	隱藏；隱匿
relating to the enjoyment or study of beauty	美感的;審美的;美學的
to help	幫助；援助
the careful and detailed examination of something in order to get information about it	細看，仔細審查
A solitary person or thing is the only person or thing in a place.	獨自的，唯一的，單個的
the quality of being strange	奇怪，古怪
awkward because of being large, heavy, or not effective	笨重的；累贅的；低效的
physically strong and solid or thick, and therefore unlikely to break or be hurt	結實的，牢固的；強壯的
having a very severe effect, or being extremely limiting	嚴重的；嚴格的，苛刻的
(especially of actions) severe and sudden or having very noticeable effects	（尤指行動）嚴厲的，猛烈的，激烈的
in a way that is natural, often sudden, and not planned or forced	自然的，自發的
great beauty that attracts admiration and attention	壯麗；雄偉；輝煌
If something is tempting, you want to do or have it.	誘人的，吸引人的;使人禁不住想嘗試（或擁有）的
If a place is teeming, it is full of people.	擠滿人的；人山人海的
a situation in which a plane turns round and round as it falls quickly towards the ground	（飛機的）尾旋，尾螺旋
the ability to feel something physically, especially by touching, or a physical feeling that results from this ability	感覺;知覺;（尤指）觸覺
Something that is tantalizing causes desire and excitement in you, but is unlikely to provide a way of satisfying that desire.	逗引性的;挑逗性的
a substance or product that can be traded, bought, or sold	商品，貨物
to go into a place or situation in which you are not wanted or not expected to be	闖入，侵擾
luxurious and showing that you are rich	奢侈的，豪華的，奢華的
If something stabilizes, it becomes fixed or stops changing.	穩定下來
happening sometimes; not regular or continuous	偶爾發生的;陣發性的;斷斷續續的
easily influenced or harmed by something	易受影響的，易受傷害的
the practice of storing a large supply of something for future use	（大量）儲備，貯存;囤積
always loyal in supporting a person, organization, or set of beliefs or opinions	忠實的;堅定的
quietly and carefully in order not to be seen or heard	秘密地，偷偷摸摸地，鬼鬼祟祟地
quickly or immediately	迅速地，快地
food	食物
