impaired	(adjective)
vast	(adjective)
meagre	(adjective)
unique	(adjective)
color	(noun)
ignore	(verb)
anecdotal	(adjective)
eschew	(verb)
devalue	(verb)
tarnished	(adjective)
ridicule	(verb)
hardiness	(noun)
delicacy	(noun)
lacking	(adjective)
need	(verb)
imagine	(verb)
nominal	(adjective)
undertake	(verb)
supplement	(verb)
mournfully	(adverb)
spitefully	(adverb)
