apathy	(noun)
zeal	(noun)
loathing	(noun)
antagonism	(noun)
astonishment	(noun)
dismay	(noun)
persevering	(adjective)
euphoria	(noun)
composure	(noun)
economize	(verb)
escalate	(verb)
confiscatory	(adjective)
cheerful	(adjective)
delight	(verb)
sojourn	(noun)
retiring	(adjective)
apprehension	(noun)
elaborate	(verb)
congruent	(adjective)
consummate	(adjective)