We all enjoyed ourselves tremendously.	我們都玩得非常開心。
an arduous climb/task/journey	舉步維艱的攀登／艱巨的任務／艱難的旅程
There was a big controversy surrounding/over the use of drugs in athletics.	體育界對使用違禁藥物爭議很大。
A heart attack is caused by the blood vessels that supply the blood to the heart muscle getting blocked.	心臟病發作是由於向心肌供血的血管堵塞引起的。
She saw him coming and crouched (down) behind a bush.	看見他來了，她便蜷伏在一簇灌木叢後面。
Divers exploring the wreck managed to salvage some coins and jewellery.	探尋沉船的潛水員設法打撈到一些硬幣和珠寶。
A workman was killed when the sides of the trench he was working in collapsed.	一名工人在挖壕溝時，由於兩側坍塌而喪生。
the depletion of the ozone layer	臭氧層的變薄
He'd fly into a rage at the slightest provocation.	哪怕是稍稍惹他一下他都會勃然大怒。
a didactic approach to teaching	說教式的教學方法
The memorial to those who had died in the war was unveiled by the Queen.	緬懷戰爭死難者的紀念碑由女王揭幕。
Smoking can cause respiratory diseases.	吸煙會導致呼吸系統疾病。
He scrutinized the men's faces carefully/closely, trying to work out who was lying.	他仔細端詳這些男人的臉，想弄清誰在撒謊。
no example found
He's always expounding on what's wrong with the world.	他總是在痛斥這個世界的弊病。
Hail and sleet are types of precipitation.	冰雹和凍雨都是降水形式。
Many hours of meticulous preparation have gone into writing the book.	為寫此書，投入了大量時間細心做前期準備。
We've had three sets of prospective buyers looking at the house.	已經有三批可能買我們房子的人來看過房子了。
The children sat listening attentively to the story.	孩子們坐著專心聽故事。
Often there's no clear evidence one way or the other and you just have to base your judgment on intuition.	很多時候，往往沒有這樣或那樣的確鑿證據，你只好憑直覺進行判斷。
That smell always evokes memories of my old school.	那種氣味經常喚起我對母校的回憶。
An elaborate system of canals was built, leading away from the Thames and ramifying throughout the UK.	建立了一個精心設計的運河系統，從泰晤士河引出，呈枝椏狀向英國各地延伸。
No one doubted that the president was a man of the highest integrity.	沒有人懷疑總裁是個光明磊落的人。
I thought that article was written at a very superficial level.	我認為那篇文章寫得很膚淺。
