tremendously	(adverb)
arduous	(adjective)
controversy	(noun)
vessel	(noun)
crouch	(verb)
wreck	(noun)
trench	(noun)
depletion	(noun)
provocation	(noun)
didactic	(adjective)
unveil	(verb)
respiratory	(adjective)
scrutinize	(verb)
discordant	(adjective)
expound	(verb)
precipitation	(noun)
meticulous	(adjective)
prospective	(adjective)
attentively	(adverb)
intuition	(noun)
evoke	(verb)
ramify	(verb)
integrity	(noun)
superficial	(adjective)
