the act of killing someone who is very ill or very old so that they do not suffer any more	安樂死
to speak to someone or a group of people, often for a long time, in a forceful and sometimes angry way, especially to persuade them	長篇大論地演說;斥責
to rub metal until it is smooth and shiny	擦亮;使有光澤
the act of communicating with the dead in order to discover what is going to happen in the future, or black magic (= magic used for bad purposes)	通靈術，（招亡魂問卜的）巫術;妖術
making you remember or imagine something pleasant	引起（愉快）回憶的;產生（美好）聯想的;喚起（美好）感情的
to criticize someone or something in a way that shows you do not respect or value him, her, or it	貶斥，貶低
behaviour that shows no interest or energy and shows that someone is unwilling to take action, especially over something important	無興趣，懈怠;（尤指對重要事情的）漠不關心，無動於衷
to complain angrily	抱怨，發牢騷
A caustic remark or way of speaking is hurtful, critical, or intentionally unkind.	（話語或說話方式）刻薄的，尖刻的，挖苦的
to make someone more powerful or important	擴大…的權勢；提高…的地位
a person, especially an old man, who is wise	智者，賢人（尤指老人）
to remove or destroy something completely	拔除；消滅；根除
showing no enthusiasm or excitement	無生氣的，不夠精彩的
bored or not excited, or wishing to seem so	不稀罕的;司空見慣的
someone who tells funny or interesting stories	善於講故事的人
relating to weather conditions	氣象的
to cause someone no longer to have a wrong idea	使改變想法;使消除誤解
a type of chemistry, especially in the Middle Ages, that dealt with trying to find a way to change ordinary metals into gold and with trying to find a medicine that would cure any disease	煉金術，煉丹術
an autonomous machine or system is able to operate without being controlled directly by humans	自治的，有自治權的
very careful and with great attention to every detail	嚴謹的，一絲不苟的；非常注意細節的
