euthanasia	(noun)
harangue	(verb)
burnish	(verb)
necromancy	(noun)
evocative	(adjective)
disparage	(verb)
apathy	(noun)
grouse	(verb)
caustic	(adjective)
aggrandize	(verb)
sage	(noun)
extirpate	(verb)
pallid	(adjective)
blas√©	(adjective)
raconteur	(noun)
meteorological	(adjective)
disabuse	(verb)
alchemy	(noun)
autonomous	(adjective)
meticulous	(adjective)
