deceive	(verb)
decipher	(verb)
deplete	(verb)
despise	(verb)
deter	(verb)
devise	(verb)
diatribe	(noun)
digress	(verb)
disproportionate	(adjective)
divert	(verb)
eloquent	(adjective)
epitome	(noun)
evade	(verb)
exemplary	(adjective)
famine	(noun)
flaw	(noun)
fortify	(verb)
frivolous	(adjective)
garbled	(adjective)
grandiose	(adjective)
hackneyed	(adjective)
haphazard	(adjective)
hasty	(adjective)
hazardous	(adjective)
hindrance	(noun)
hollow	(adjective)
