connected with thinking or conscious mental processes	感知的;認知的;認識力的
the ability to feel something physically, especially by touching, or a physical feeling that results from this ability	感覺;知覺;（尤指）觸覺
the fact of finding interesting or valuable things by chance	（偶然發現有趣或珍貴之物的）機緣，幸運
not kind or showing sympathy; not willing to accept other people's mistakes or failures	不和善的;冷酷的;嚴厲的;苛刻的
If people or their beliefs are uncompromising, they are fixed and do not change, especially when faced with opposition.	（尤指遭到反對時人或其信念）不妥協的，不讓步的，強硬的
the act of moving something from one place to another	轉移
a person who gives some of their blood or a part of their body to help someone who is ill	捐血者;器官捐贈者
to encourage the development or growth of ideas or feelings	鼓勵；促進；培養
to come to an opinion about something, or have a belief about something	認為;看待;視為
to remember officially and give respect to a great person or event, especially by a public ceremony or by making a statue or special building	（尤指舉行公開儀式或豎立雕塑或特別建築）紀念，緬懷
extremely loving and loyal	摯愛的;忠實的，忠誠的
a strong opinion or belief	堅定的看法;堅定的信念;堅定的信仰
a situation in which two people or groups of people become friendly again after they have argued	和解;和好;修好
very little and not enough	少量的；不足的；貧乏的
to add proof to an account, statement, idea, etc. with new information	證實，確證
strange or unusual, sometimes in a humorous way	怪異的，古怪的；異乎尋常的
the fact of an event happening, an invention being made, or a person arriving	（事件、發明或人物的）出現，來臨，到來
to remove something intentionally	抹去，擦掉;消除
different or becoming different from something else	有差異的;有分歧的
to cause great physical or mental pain to someone intentionally	拷打;拷問;折磨;虐待
If lines, roads, or paths converge, they move towards the same point where they join or meet.	（幾條線或道路）會合，交會，匯合
happening or found by chance	偶然的
to get rid of something completely or destroy something bad	根除;消滅;杜絕
moving or behaving in a way that is not regular, certain, or expected	（動作、行爲等）不規則的，不確定的，無計劃的
to force someone to have sex when they are unwilling, using violence or threatening behaviour	強姦;強暴
a group of people, often of related families, who live together, sharing the same language, culture, and history, especially those who do not live in towns or cities	部落;部族
(especially of actions) severe and sudden or having very noticeable effects	（尤指行動）嚴厲的，猛烈的，激烈的
Fertile land can produce a large number of good quality crops.	肥沃的;富饒的
poisonous or not pure	受污染的
to escape by running away, especially because of danger or fear	（尤指因危險或恐懼而）逃跑
to put a dead body into the ground	埋;埋葬，安葬
not directly connected with or related to something	無直接關係的；無關的
the income that a government or company receives regularly	（政府的）稅收，歲入;（公司的）收益
familiar with something	習慣的；適應了的
to pay attention to something, especially advice or a warning	注意，聽從（尤指建議或警告）
to provide with a place to live or to be stored in	為…提供住宿;容納;為…提供空間
really and sincerely	確實;的確
careful and using a lot of effort	認真刻苦的，勤奮的，勤勞的
Inert substances do not produce a chemical reaction when another substance is added.	惰性的，不活潑的
making someone look or seem better or more attractive than usual	使人顯得更漂亮的;奉承的
Something or someone that is indispensable is so good or important that you could not manage without it, him, or her.	必不可少的，必需的
ill or needing care, especially for long periods and often because of old age	（尤指因年邁而長期）病弱的，需要照顧的
soldiers on duty in a large group	部隊，軍隊
nused to refer to plants and animals that grow or live naturally in a place, and have not been brought there from somewhere else	當地的;本土的，土生土長的
having an appearance that looks important or causes admiration	壯觀的，宏偉的;氣宇不凡的
to become or to make something larger or more important	抬高;誇大
to (cause to) gradually disappear or waste	（使）逐漸消失;（使）逐漸浪費掉
causing you to have fear or respect for something or someone because that thing or person is large, powerful, or difficult	可怕的；令人敬畏的；難對付的
to change, especially continuously and between one level or thing and another	（尤指持續）波動，起伏不定
not having an obvious order or plan	無秩序的，無計劃的，隨意的
a strange or unusual habit, way of behaving, or feature that someone or something has	癖好，怪癖;特徵
to invent or produce something false in order to deceive someone	捏造，虛構;偽造
a sudden attack on or act of going into a place, especially across a border	（尤指跨越邊境的）侵入，侵犯
to remove earth that is covering very old objects buried in the ground in order to discover things about the past	發掘;挖出
