cognitive	(adjective)
sensation	(noun)
serendipity	(noun)
severe	(adjective)
uncompromising	(adjective)
transplantation	(noun)
donor	(noun)
foster	(verb)
perceive	(verb)
commemorate	(verb)
devoted	(adjective)
conviction	(noun)
reconciliation	(noun)
scant	(adjective)
corroborate	(verb)
eccentric	(adjective)
advent	(noun)
efface	(verb)
divergent	(adjective)
torture	(verb)
converge	(verb)
serendipitous	(adjective)
eradicate	(verb)
erratic	(adjective)
rape	(verb)
tribe	(noun)
drastic	(adjective)
fertile	(adjective)
contaminated	(adjective)
flee	(verb)
bury	(verb)
extraneous	(adjective)
revenue	(noun)
accustomed	(adjective)
heed	(noun)
accommodate	(verb)
genuinely	(adverb)
diligent	(adjective)
inert	(adjective)
flattering	(adjective)
indispensable	(adjective)
infirm	(adjective)
troop	(noun)
indigenous	(adjective)
imposing	(adjective)
inflate	(verb)
dissipate	(verb)
formidable	(adjective)
fluctuate	(verb)
haphazard	(adjective)
idiosyncrasy	(noun)
fabricate	(verb)
incursion	(noun)
excavate	(verb)
