noisome	(adjective)
restive	(adjective)
considering	(preposition)
because	(conjunction)
imprudent	(adjective)
ingenuous	(adjective)
bland	(adjective)
toothsome	(adjective)
scanty	(adjective)
robust	(adjective)
lucid	(adjective)
prosaic	(adjective)
abstruse	(adjective)
while	(conjunction)
cheap	(adjective)
poisonous	(adjective)
singular	(adjective)
eliminate	(verb)
duplicate	(verb)
preserve	(verb)
