giving useful or interesting information	有啟發性的；有教育意義的
existing as a natural or basic part of something	內在的；固有的，生來就有的
to save goods from damage or destruction, especially from a ship that has sunk or been damaged or a building that has been damaged by fire or a flood	（尤指從失事船隻、火災或水災中）搶救，打撈
very interesting because of being unusual or mysterious	非常有趣的;引人入勝的;神秘的
happening soon	即將發生的
(especially of a business, job, or activity) producing a lot of money	（尤指生意、職位或活動）賺錢的，盈利的
unusual and strange, sometimes in an unpleasant way	奇怪的，古怪的
to be forced to do something or feel that you must do something	被迫做某事；必須做某事；只好做某事
a type of machine through which liquid or gas flows and turns a special wheel with blades in order to produce power	渦輪機，葉輪機，透平機
not known to many people	無名的；鮮為人知的；默默無聞的
too many to be counted	無數的，數不清的
something or someone that you think about all the time	困擾;無法擺脫的念頭;念念不忘的事（或人）
in a way that shows great care and attention to detail	細致地，小心翼翼地
extremely small	微小的，極小的
A malleable substance is easily changed into a new shape.	具延展性的；易變形的
having a lot of small parts that are arranged in a complicated or delicate way	錯綜複雜的；複雜精細的；難理解的；難解決的
someone's ability to think of clever new ways of doing something	心靈手巧;足智多謀;獨創力
the quality of being legal	合法性
to get rid of something or someone that is not wanted or needed	把…作為廢物拋棄，扔掉
to (cause something or someone to) move suddenly and violently	（使）震動，（使）猛然搖動
very ordinary and therefore not interesting	世俗的；單調的；平凡的
the opposite	相反；反面；對立面；相反事物
to cause someone who is angry or upset to be calm and satisfied	使平靜，平息;安撫
the rise and fall of the sea that happens twice every day	潮汐;潮水
intentionally	故意地
preventing light from travelling through, and therefore not transparent or translucent	不透明的；不透光的
violent action organized by a group of people who are trying to change the political system in their country	反叛，造反;叛亂
to act according to an order, set of rules, or request	服從；遵守；依從
a person who writes plays	劇作家
an unpleasant situation that is difficult to get out of	尷尬的處境，窘境，困境
to prevent something or make it impossible, or prevent someone from doing something	排除，防止，杜絕；阻礙
a form of a language that people speak in a particular part of a country, containing some different words and grammar, etc.	方言，土語，地方話
a serious or formal promise, especially one to give money or to be a friend, or something that you give as a sign that you will keep a promise	誓言;諾言;保證
(especially of a power thought to be greater than ordinary people) to decide or fix what will happen in a way that cannot be changed or controlled	（尤指超越凡人的力量）預先決定，預先規定，註定
to add decoration to something	裝飾，點綴
an idea or theory on which a statement or action is based	（作為先決條件的）假定，前提
the most successful or admired part of a system or achievement	極點；頂點，頂峰
to spread through something and be present in every part of it	滲透；瀰漫；遍佈；充滿
mostly or mainly	佔主導地位地；佔絕大多數地；顯著地
