to cause fresh air to enter and move around a closed space	使通風;使空氣流通
lack of activity or interest, or unwillingness to make an effort to do anything	缺乏活力，惰性
able to burn easily	可燃的，易燃的
to exist in an unpleasant or unwanted situation, often for a long time	受苦，經歷苦難，受煎熬
a situation in which people are extremely poor over a long period	赤貧
to answer someone quickly in an angry or funny way	（憤怒或風趣地）反駁，回嘴
to give someone so much work or so many things that they cannot deal with it all	使應接不暇
to ask for and get help or support from someone	爭取，謀取（幫助或支援 ）
to (cause something to) shake or move from side to side in a way that shows poor balance	（使）搖晃，（使）搖擺
a substance or surface that an organism grows and lives on and is supported by	基質，培養基
a person who writes plays	劇作家
not needing or without oxygen	厭氧的;無氧的
to dry something out because of too much heat and not enough rain.	使乾枯，使乾涸
similar to or in agreement with something, so that the two things can both exist or can be combined without problems	一致的；適合的
coming before a more important action or event, especially introducing or preparing for it	初步的，起始的;預備的
to search a place or thing very carefully in order to try to find something	認真搜索，細查
a special power that some people have naturally that makes them able to influence other people and attract their attention and admiration	超凡的個人魅力;吸引力;超凡氣質
an occasion when many large animals or many people suddenly all move quickly and in an uncontrolled way, usually in the same direction at the same time, especially because of fear	（尤指獸群或人群因恐懼引發的）狂奔;奔逃，蜂擁
to say that something is true or is a fact	聲稱;斷言;主張
weak and in bad health because of having too little food or too little of the types of food necessary for good health	營養不良的
the process of improving or correcting a situation	補救；矯正，糾正
to face, meet, or deal with a difficult situation or person	面對，面臨；遭遇；直面，正視
the thin, dried skin of some animals that was used in the past for writing on, or a high-quality paper made to look like this	（舊時書寫用的）羊皮紙;仿羊皮紙
If a physical or emotional feeling ebbs, it becomes less strong or disappears.	衰退；逐漸減少；衰竭
to cut or tear something roughly into thin strips	把…切（或撕）成細條；切碎；撕碎
to argue that a statement or claim is not true	反駁;駁斥;駁回
to guess, based on the appearance of a situation and not on proof	推測；猜測，猜想；臆斷
government by a ruler or small group of people who have unlimited power over the people in their country or state and use it unfairly and cruelly	暴政，專制統治
expressing disapproval, or suggesting that something is not good or is of no importance	貶抑的，貶損的
the physical and/or mental strength to do something that might be difficult and will take a long time	耐力；耐性；持久力
Perishable food decays quickly.	（食物）易腐爛的，易變質的
to waste money or supplies, or to waste opportunities by not using them to your advantage	浪費，揮霍（金錢或補給品）;糟蹋（機會）
having little value or importance	微不足道的，瑣碎的；沒有價值的
a large picture that has been painted on the wall of a room or building	壁畫
a young tree	樹苗，小樹，幼樹
