ventilate	(verb)
inertia	(noun)
combustible	(adjective)
languish	(verb)
grinding	(adjective)
retort	(verb)
inundate	(verb)
enlist	(verb)
wobble	(verb)
substrate	(noun)
playwright	(noun)
anaerobic	(adjective)
parch	(verb)
congruent	(adjective)
preliminary	(adjective)
scour	(verb)
charisma	(noun)
stampede	(noun)
contend	(verb)
malnourished	(adjective)
remediation	(noun)
confront	(verb)
parchment	(noun)
ebb	(verb)
shred	(verb)
rebut	(verb)
conjecture	(verb)
tyranny	(noun)
pejorative	(adjective)
stamina	(noun)
perishable	(adjective)
squander	(verb)
trivial	(adjective)
mural	(noun)
sapling	(noun)
