fossil	(noun)
algae	(noun)
ubiquitous	(adjective)
carving	(noun)
halting	(adjective)
tremendously	(adverb)
conjoin	(verb)
conquer	(verb)
elongated	(adjective)
carnivorous	(adjective)
exquisite	(adjective)
futile	(adjective)
contend	(verb)
entrenched	(adjective)
intricate	(adjective)
confine	(verb)
ludicrous	(adjective)
imminent	(adjective)
mitigate	(verb)
obscure	(adjective)
capacious	(adjective)
delineate	(verb)
gradual	(adjective)
restrained	(adjective)
microorganism	(noun)
canal	(noun)
connote	(verb)
bleach	(verb)
dialect	(noun)
perceive	(verb)
stratification	(noun)
