behaviour that shows no interest or energy and shows that someone is unwilling to take action, especially over something important	無興趣，懈怠；（尤指對重要事情的）漠不關心，無動於衷
great enthusiasm or eagerness	熱忱，熱情；激情
a strong feeling of hating someone or something	憎恨，憎惡
happy and positive	高興的，快樂的；興高采烈的
hate, extreme unfriendliness, or active opposition to someone	對抗，對立；敵對；敵意
(something or someone that gives) great pleasure, satisfaction, or happiness	欣喜；滿足；愜意
very great surprise	驚愕；驚訝
a feeling of unhappiness and disappointment	沮喪，灰心，失望
a short period when a person stays in a particular place	寄居
unwilling to be noticed or to be with other people	不願與人交往的；離群索居的；孤僻的
determined to continue to do or to try to achieve something, despite problems	堅持的，不懈的
extreme happiness, sometimes more than is reasonable in a particular situation	狂喜；亢奮；異常興奮
the feeling of being calm, confident, and in control	鎮靜，沉著，泰然自若
worry about the future, or a fear that something unpleasant is going to happen	（對未來或即將發生的不愉快之事的）憂慮，擔心；恐懼
to try to save money by reducing the amount that you are spending	節約，節省；緊縮開支
to become or make something become greater or more serious	（使）增強；（使）擴大；（使）加劇；（使）惡化
containing a lot of careful detail or many detailed parts	精心計劃（或製作）的；詳盡的；複雜的
similar to or in agreement with something, so that the two things can both exist or can be combined without problems	一致的；適合的
used to describe the act of something being taken away from someone by a government, etc.	沒收的
perfect, or complete in every way	完美無缺的；圓滿的
a sudden wish or idea, especially one that cannot be reasonably explained	突然的念頭，衝動
a fixed, especially religious, belief or set of beliefs that people are expected to accept without any doubts	（尤指宗教的）教義，教條，信條
an idea or explanation for something that is based on known facts but has not yet been proved	假設，假說
something that you like very much for a short period	一時的興趣（或愛好）
one of the principles on which a belief or theory is based	信條；宗旨；原則
a society or state considered as a political unit	政治組織
false and not what it appears to be, or (of reasons and judgments) based on something that has not been correctly understood and therefore false	虛假的，欺騙的；（原因、判斷）謬誤的
using few words, sometimes in a way that seems rude or unfriendly	簡短生硬的；簡要的
not correct	錯誤的，謬誤的
expressing what needs to be said without unnecessary words	簡明的；言簡意賅的
wishing to fight or start a war	好戰的;好鬥的
happy and without worry	歡樂的，愉快的；無憂無慮的
to praise something or someone very much	讚揚；讚頌；讚美
to not approve of something or say that you do not approve of something	反對，不贊成
to say formally or publicly that you no longer own, support, believe in, or have a connection with something	聲明放棄；宣佈放棄；棄絕
to refuse to accept something or someone because you feel that thing or person is not worth having	輕蔑地拒絕；摒棄
to show disapproval of:	不贊成
to praise someone or something in a speech or piece of writing	歌頌，讚美，稱頌