relating to or based on subjects or a theme	主題的;議題的
a planned way of doing something	策略，手法
the period of new growth of interest and activity in the areas of art, literature, and ideas in Europe during the 15th and 16th centuries	（15和16世紀時歐洲，尤指義大利北部的）文藝復興，文藝復興時期
a child's vehicle with two or three small wheels joined to the bottom of a narrow board and a long vertical handle attached to the front wheel. It is ridden by standing with one foot on the board and pushing against the ground with the other foot.	（小孩的）踏板車
unable to be noticed or felt because of being very slight	察覺不出的，難以察覺的
very little and not enough	少量的；不足的；貧乏的
very wrong and unfair	極其錯誤的；極不公正的
to speak seriously about something, especially in a law court, or to give or provide proof	證明，證實;作證
intended or likely to cause anger or hate	使人激憤的;煽動性的
to steal goods violently from a place, especially during a war	（尤指戰爭期間的）掠奪，搶劫，劫掠
able to be seen or understood	能看出的;可辨別出的;能明白的
If a theory or argument is untenable, it cannot be supported or defended against criticism.	（理論或論點）難以捍衛的，站不住腳的
just beginning	剛開始的;早期的
a person who is elected or chosen to lead the group who governs a town or city	市长
making you feel less worried	令人感到寬慰的;使人安心的;使人放心的
a piece of rock or other matter from space that has landed on earth	隕星；隕石
poisonous or not pure	受污染的
the distant past (= a long time ago), especially before the sixth century	（尤指六世紀以前的）古代
a severe moral or physical limit	限制;約束;束縛
the crime of using force or threats to take control of an aircraft, ship, car, etc., or an occasion when this happens	劫持（飛機、輪船、車輛等）；劫持事件
(especially of a disease or something bad) continuing for a long time	（尤指疾病或不好的事物）慢性的，長期的
extremely sad and alone or empty	孤寂的;傷心寂寞的
a bicycle made for two people who sit one behind the other	雙人自行車
in a way that is mysterious and difficult to understand	神秘地，隱秘地;費解地
to prevent something from being seen or known about	隱藏；隱匿；隱瞞；隱蔽
very noticeable or attracting attention, often in a way that is not wanted	顯眼的；醒目的；顯著的
a roughly cut piece	大塊;厚塊
with special permission not to do or pay something	被免除（義務或付款）的;被豁免的
too serious and full of importance	妄自尊大的，自以為是的
