thematic	(adjective)
tactic	(noun)
the Renaissance	(noun)
scooter	(noun)
imperceptible	(adjective)
scant	(adjective)
iniquitous	(adjective)
testify	(verb)
inflammatory	(adjective)
plunder	(verb)
discernible	(adjective)
untenable	(adjective)
incipient	(adjective)
mayor	(noun)
reassuring	(adjective)
meteorite	(noun)
contaminated	(adjective)
antiquity	(noun)
stricture	(noun)
hijacking	(noun)
chronic	(adjective)
desolated	(adjective)
tandem	(noun)
cryptically	(adverb)
conceal	(verb)
conspicuous	(adjective)
chunk	(noun)
exempt	(adjective)
pompous	(adjective)
