fungus	(noun)
anorexia nervosa	(noun)
prolonged	(adjective)
torso	(noun)
fountain	(noun)
maternal	(adjective)
mythological	(adjective)
maturity	(noun)
wisdom	(noun)
cruciate	(adjective)
ligament	(noun)
anorexic	(noun)
metabolize	(verb)
discrepancy	(noun)
lynch	(verb)
luminescent	luminescent
malnutrition	(noun)
mangled	(adjective)
stabilize	(verb)
manifestation	(noun)
manipulate	(verb)
metabolism	(noun)
anxious	(adjective)
speculate	(verb)
parasite	(noun)
ritual	(noun)
deity	(noun)
rubble	(noun)
prehistoric	(adjective)
regimented	(adjective)
sacred	(adjective)
electorate	(noun)
secular	(adjective)
ambitious	(adjective)
meticulous	(adjective)
refract	(verb)
restrain	(verb)
domesticated	(adjective)
rudimentary	(adjective)
salivate	(verb)
