expressing unfair or false criticism that is likely to damage someone's reputation	詆毀的，誹謗的
unexpected events or changes that cannot be controlled and can influence a situation	變幻無常的事件;不可捉摸的變化
a failure to understand something, or an understanding or belief about something that is not correct	誤解，誤會
the effect that an action, event, or decision has on something, especially a bad effect	（尤指壞的）影響，反響；惡果
very big	巨大的
having little value or importance	沒有價值的；微不足道的
strange and unusual and difficult to accept or like	稀奇古怪的；不尋常的；難以接受的
behaving as if you are better than other people, and that their opinions, beliefs, or ideas are not important	傲慢自大的，目中無人的，目空一切的
done quickly, without taking care or interest	草率的；馬虎的；敷衍的
to encourage someone to do or feel something unpleasant or violent	鼓動，煽動
to end a law, agreement, or custom formally	正式廢除，廢止;撤銷
to wake someone up or make someone more active or excited	喚醒;激勵，使覺醒，使奮起
refusing to change your opinions or behaviour	固執的，不妥協的，不讓步的
(of people) liking to be with other people	（人）愛交際的，不喜獨處的
using too many words and therefore boring or difficult to read or listen to	冗長的;囉唆的;好長篇大論的
(of speech or writing) expressing an idea cleverly in a few words	（講話或寫作）言簡意賅的，簡潔有力的
not known or understood by many people	難解的;深奧的
to manage cleverly to avoid dealing with a difficult question or some criticism	（巧妙地）迴避（難題或批評）
to bring together or organize people or things in order to achieve a particular aim	集中;統率;管理
to cause someone who is angry or upset to be calm and satisfied	使平靜，平息;安撫
