a part of your body that has become bigger because of illness or injury	腫的地方，腫脹處;腫塊
a vote in which all the people in a country or an area are asked to give their opinion about or decide an important political or social question	（就重大政治或社會問題進行的）全民公決，全民公投
a gradual increase or growth by the addition of new layers or parts	堆積，積聚；逐漸的增加，增大
to discover something in the ground	發掘，掘出，使出土
to move slowly and awkwardly	緩慢笨拙地移動
to (cause to) shake violently with sudden uncontrolled movements	（使）劇烈抖動;（使）抽搐，（使）痙攣
the first public performance of a play or any other type of entertainment	首映，首演
to bite or chew something repeatedly, usually making a hole in it or gradually destroying it	咬，嚙，啃（通常指啃出孔洞或逐漸啃壞）
excellent, or beautiful and impressive	極佳的，非常好的；華麗的；壯麗的
(especially of a business, job, or activity) producing a lot of money	（尤指生意、職位或活動）賺錢的，盈利的
to (cause to) change from a solid, frozen state to a liquid or soft one, because of an increase in temperature	（使）融化;（使）解凍
producing or reflecting bright light, especially in the dark	（尤指在黑暗中）發亮的，放光的;夜光的
to get control or influence	佔優勢，占上風
a person or group that supports an activity or organization, especially by giving money	贊助者，資助人
a pattern or picture made using many small pieces of coloured stone or glass, or the activity or method of making these	馬賽克;鑲嵌圖案;鑲嵌畫
to think carefully about something, especially for a noticeable length of time	沉思，默想，考慮
to move further away into the distance, or to become less clear or less bright	逐漸遠離；變得模糊，逐漸淡漠
with many turns and changes of direction; not direct or simple	彎彎曲曲的；曲折的；轉彎抹角的
US spelling of paralyse	（paralyse的美式拼寫）
developing quickly	迅速發展的
total, or expressed in a clear and certain way	完全的；表達明確的；毫不含糊的
weak and without energy, strength, or power	虛弱的；衰弱的，無力的
to cruelly and unfairly kill a lot of people	屠殺，殺戮
to lose the determination to oppose something; to accept defeat	屈從，屈服；放棄抵抗；承認失敗
a class of people who hold high social rank	貴族，貴族階級
to cover a place or thing with a large amount of water	淹沒，浸沒
to call someone in order to attract their attention	招呼，呼喊
to say that someone has done something illegal or wrong without giving proof	（未經證實地）指責，宣稱，指控
to take something into your possession again, especially by force	（尤指用武力）奪回，收復，重新佔領
a scientific description of the culture of a society by someone who has lived in it, or a book containing this	人種誌，人種論;人種誌著作
