to criticize or make damaging remarks or judgments about someone or something:	沒有中文解釋
to begin a discussion of something difficult	開始討論;提出（難題等）
something that deters people from doing something	威懾力量；遏制因素；制止物
Something that is porous has many small holes, so liquid or air can pass through, especially slowly.	多孔的;能滲漏的
If two or more things coalesce, they come or grow together to form one thing or system.	聯合，合併
clothes	衣服
existing as a natural or basic part of something	內在的；固有的，生來就有的
the ability, especially of a medicine or a method of achieving something, to produce the intended result	功效，效力，效能
→  sensual	感官的；（尤指）肉欲的，愉悅肉體的，滿足肉欲的
very clear in meaning and easy to understand	（意思）清楚明白的，清晰的
an extremely strong wish to get or keep money or possessions	貪得無厭;貪婪
a long list of unpleasant things, especially things that are repeated:	據報道，製造商已經收到了顧客一連串不滿意的投訴。
to increase a lot and suddenly in number	激增
a long and violent argument between people or families, in which one group tries to harm the other in order to punish them for things that happened in the past	世仇;族間血仇;宿怨
happening sometimes; not regular or continuous	偶爾發生的;陣發性的;斷斷續續的
able to experience feelings	有知覺力的；有感覺力的
poetry that is silly or badly written	蹩腳詩;打油詩
to follow a different direction, or to be or become different	（道路）分叉；出現差異；發生分歧
lasting a very long time, or happening repeatedly or all the time	長期存在的;常年的;不斷發生的;反覆的
refusing to obey or show respect	不服從的;藐視的
