showing willingness to end a disagreement, or trying to make someone less angry	願意和解的;調停的，安撫的
arguing and complaining a lot	愛爭吵且抱怨不休的
not showing emotions or thoughts and therefore very difficult to understand or get to know	（尤指人或其表情）高深莫測的，難以捉摸的
causing , involving, or likely to cause disagreement and argument	有爭議的;引起爭論的;可能引發爭議的
having or showing courage	勇敢的，有膽量的，有勇氣的
morally bad and making you feel ashamed	卑鄙的，可恥的
not serious about a serious subject, in an attempt to be funny or to appear clever	（尤指不問場合）好開玩笑的;滑稽的，詼諧的
someone who criticizes something or someone, often unfairly	惡意批評者，貶低者
someone who has recently become involved in an activity and is still learning about it	新手;初學者
a person who knows a lot about and enjoys one of the arts, or food, drink, etc. and can judge quality and skill in that subject	（藝術品、食品、飲料等的）鑒賞家，鑒定家，行家
a person who is not satisfied with the way things are, and who complains a lot and is unreasonable and difficult to deal with	不滿者；滿腹牢騷者
having little value or importance	微不足道的，瑣碎的；沒有價值的
not thinking about or interested in someone or something	不感興趣的;不關心的，冷淡的
used to describe people who use their attractiveness to influence people or to make other people like them	會哄人的;善於施展魅力的
likely to change suddenly and unexpectedly, especially by getting worse	不穩定的；易變的；易怒的，喜怒無常的
having good moral qualities and behaviour	道德高尚的;擁有美德的;品行端正的
to promise that something will happen or exist	保證;擔保;保障
in a dangerous state because of not being safe or not being held in place firmly	危險的；不牢靠的，不穩的
a group of people who have a great knowledge and understanding of a particular subject, especially one of the arts	（尤指藝術方面的）鑒賞家，專家，行家
people who are without knowledge or experience of a particular subject or activity	缺乏專門知識者;不知情者;門外漢，外行

