conciliatory	(adjective)
cantankerous	(adjective)
inscrutable	(adjective)
contentious	(adjective)
courageous	(adjective)
ignoble	(adjective)
facetious	(adjective)
detractor	(noun)
neophyte	(noun)
connoisseur	(noun)
malcontent	(noun)
trivial	(adjective)
indifferent	(adjective)
charming	(adjective)
volatile	(adjective)
virtuous	(adjective)
guarantee	(verb)
precarious	(adjective)
cognoscenti	(noun)
the uninitiated	(noun)

