dispute	(noun)
negotiation	(noun)
prosecutor	(noun)
overthrow	(verb)
hung	(verb)
gnarled	(adjective)
lawn	(noun)
accede to sth (phrasal verb)
instil	(verb)
resist	(verb)
conspire	(verb)
deliberately	(adverb)
stem	(noun)
unanimous	(adjective)
deem	(verb)
prestigious	(adjective)
itinerary	(noun)
attorney	(noun)
abdomen	(noun)
volcanic	(adjective)
eruption	(noun)
debris	(noun)
unprecedented	(adjective)
undulate	(verb)
imprecise	(adjective)
intestine	(noun)
condemnation	(noun)
avalanche	(noun)
inadequate	(adjective)
exploitation	(noun)
medication	(noun)
disclose	(verb)
illumination	(noun)
controversial	(adjective)
mortality	(noun)
autism	(noun)
disorder	(noun)
phobia	(noun)
propensity	(noun)
prestigious	(adjective)
intact	(adjective)
emancipation	(noun)
epidemic	(noun)
pervasive	(adjective)
feasible	(adjective)
enshroud	(verb)

