a very large amount of something, especially a larger amount than you need, want, or can deal with	過多，過剩
a puzzle (= a problem you have to solve) consisting of one or more pictures and sometimes one or more letters or symbols that together represent a word or phrase :	沒有中文解釋
(of a government or other authority) to not allow something	（政府或其他權力機構）禁止
behaving wrongly in some way, especially by leaving home	（尤指離家出走而）犯錯的，行爲不當的，出格的
suitable and right for the occasion	適當的；恰當的；貼切的
the quality of being severe in the way that you speak and behave	（言語、舉止的）嚴厲，粗暴
(of an animal) eating plants	（動物）食草的
a rule for action or behaviour, especially obtained from moral thought	（尤指道德方面的）戒律，規矩，準則
extremely old-fashioned	早已過時的，十分老式的
an unnaturally strong wish for power and control, or the belief that you are very much more important and powerful than you really are	誇大狂，自大狂;妄自尊大
the quality of only being interested in your own country or group and not being willing to accept different or foreign ideas	狹隘，僵化
to support or improve something or make it stronger	支撐;加固;提高;改善
awkward and uncomfortable with other people, especially because young and without experience	（尤指因年輕且經驗不足而）笨拙的，不善社交的，不老練的
not able or willing to take decisions or actions	猶豫不決的，優柔寡斷的
extremely small	微小的，極小的
people with a good education who know a lot about literature	文人，學士
(of parts of the body) able to hold on to things, especially by curling around them	（肢體部位）能抓的，能握的;（尤指）能纏繞的
an amount or supply that is not large enough	不足，缺乏，缺少
to remove a difficulty, especially so that action to deal with it becomes unnecessary	排除，消除；使無必要
weak and without much power	弱不禁風的；了無生氣的；軟弱無能的
