relating to demography (= the study of populations and the different groups that make them up)	人口的;人口統計的;人口學的
to develop or grow quickly	迅速發展；快速生長
a feeling of pleasure and also slight sadness when you think about things that happened in the past	對往事的懷念，懷舊，念舊
a system for naming and organizing things, especially plants and animals, into groups that share similar qualities	分類學;生物分類學
statements, especially on religious or moral subjects, that are not sincerely believed by the person making them	（尤指關於宗教或道德話題的）假話，空話，偽善言語
causing sleep or making a person want to sleep	催眠的，使人昏昏欲睡的
severe criticism and blame	譴責;抨擊;討伐;責難
a noisy argument or fight	高聲爭吵;激烈打鬥
sad and thinking about something that is impossible or in the past	傷感的;留戀的
to put someone or something into a lower or less important rank or position	貶職;使降級;降低…的地位
an occasion when two or more things join or are combined	融合；結合；熔合；合併
a position which involves little work, but for which the person is paid	坐領乾薪的職位，閒職 ，冗職
to speak in a way that is intentionally not clear and confusing to other people, especially to hide the truth	（尤指爲隱瞞真相而）說模稜兩可的話，含糊其詞
based on what is experienced or seen rather than on theory	以經驗（或實驗）爲依據的；經驗主義的；來自經驗（或觀察）的
to make something secret known	洩露，透露（秘密）
someone who has recently become involved in an activity and is still learning about it	新手;初學者
to have someone's attention completely so that they cannot think of anything else	迷住；迷惑
to honour or very much respect a person or thing	尊重;敬重
connected with language or the study of language	語言的;語言學的
a person who praises and is artificially pleasant to people in authority, usually in order to get some advantage from them	諂媚者，馬屁精
