(of people) liking to be with other people	（人）愛交際的，不喜獨處的
rude and not considering other people's feelings	粗魯的，粗暴的，失禮的
too eager to praise or obey someone	巴結的，諂媚的；卑躬屈膝的
unwilling to speak about your thoughts or feelings	沈默寡言的；不願交談的
expressing unfair or false criticism that is likely to damage someone's reputation	詆毀的，誹謗的
unexpected events or changes that cannot be controlled and can influence a situation	變幻無常的事件；不可捉摸的變化
a failure to understand something, or an understanding or belief about something that is not correct	誤解，誤會
the effect that an action, event, or decision has on something, especially a bad effect	（尤指壞的）影響，反響；惡果
very big	巨大的
having little value or importance	沒有價值的；微不足道的
strange and unusual and difficult to accept or like	稀奇古怪的；不尋常的；難以接受的
behaving as if you are better than other people, and that their opinions, beliefs, or ideas are not important	傲慢自大的，目中無人的，目空一切的
done quickly, without taking care or interest	草率的；馬虎的；敷衍的
(of people) liking to be with other people	（人）愛交際的，不喜獨處的
using too many words and therefore boring or difficult to read or listen to	冗長的；囉唆的；好長篇大論的
(of speech or writing) expressing an idea cleverly in a few words	（講話或寫作）言簡意賅的，簡潔有力的
difficult to understand	難解的；深奧的
to encourage someone to do or feel something unpleasant or violent	鼓動，煽動
to manage cleverly to avoid dealing with a difficult question or some criticism	（巧妙地）迴避（難題或批評）
to bring together or organize people or things in order to achieve a particular aim	集中;統率;管理
to cause someone who is angry or upset to be calm and satisfied	使平靜，平息；安撫
to end a law, agreement, or custom formally	正式廢除，廢止；撤銷
to wake someone up or make someone more active or excited	喚醒；激勵，使覺醒，使奮起
refusing to change your opinions or behaviour	固執的，不妥協的，不讓步的
very unpleasant and offensive	極令人不快的；令人厭惡的
unwilling to be controlled or be patient	難駕馭的，不受管束的；焦躁不安的
used to mention a particular condition or fact about something, usually a disadvantage	考慮到；就…而言
despite the fact that; although	雖然；儘管
for the reason that	因為，由於
unwise, by failing to consider the likely results of your actions	不明智的；不謹慎的，輕率的
used to describe goods that are both low in quality and low in price	（商品）質次價廉的
honest, sincere, and trusting, sometimes in a way that seems silly	天真的；胸無城府的
very harmful and able to cause illness or death	有毒的，有害的
not having a strong taste or character or not showing any interest or energy	無滋味的；枯燥乏味的；沒精打采的，無生氣的
(especially of food) attractive or pleasant	（尤指食物）吸引人的，可口的
smaller in size or amount than is considered necessary or is hoped for	少量的；不足的；缺乏的
(of a person or animal) strong and healthy, or (of an object or system) strong and unlikely to break or fail	（人或動物）強壯的，茁壯的；（東西或系統）堅固的，耐用的，結實的
of an unusual quality or standard; noticeable	特別的；引人注意的
clearly expressed and easy to understand, or (of a person) thinking or speaking clearly	清晰的，明瞭的；（人）頭腦清醒的，說話清楚的
without interest, imagination, and excitement	乏味的；平淡無奇的；缺乏想像力的
difficult to understand	難解的；深奧的
to remove or take away someone or something	排除;消除;清除
to make an exact copy of something	複製，拷貝
to keep something as it is, especially in order to prevent it from decaying or being damaged or destroyed	保護，維護；保存；保養
to keep or continue to have something	保持;保留;保有
to remove or destroy something completely	拔除；消滅；根除
to prepare land and grow crops on it, or to grow a particular crop	耕作;栽培;種植
unusual or special and therefore surprising and worth mentioning	非凡的；奇異的；引人注目的
extremely good	非常好，極好
central and important	關鍵性的，核心的
not known about by many people and difficult to understand	深奧的;玄妙的;晦澀的
of or from a long time ago, having lasted for a very long time	古代的；古老的；年代久遠的
very important because of effects on future events	重大的，重要的
waste material or rubbish, especially left after a particular event	（尤指某項活動後留下的）廢棄物，垃圾
(a place that gives) protection or shelter from danger, trouble, unhappiness, etc.	避難（所）;庇護（所）;慰藉
the quality of being unpleasantly bright in colour or decoration	俗麗;花哨;艳丽
a noisy situation with no order	喧鬧，混亂喧鬧的場面
unwanted waste material, especially material that is regularly thrown away from a house, factory, etc.	（尤指家庭、工廠等固定産生的）廢物，廢料，垃圾
the state of not being able to produce plants or fruit	貧瘠
very careful to behave correctly or to give attention to details	一絲不苟的；循規蹈矩的
Vociferous people express their opinions and complaints loudly and repeatedly in speech, and vociferous demands, etc. are made repeatedly and loudly.	大聲疾呼的；大聲叫喊的；喧嚷的
(of a person) funny in a clever way	（人）幽默的，詼諧的
Vicious people or actions show an intention or wish to hurt someone or something very badly.	邪惡的;惡毒的;兇暴的
criticizing someone or something in a severe and unkind way	嚴厲批評的，尖刻斥責的
using words in a clever and funny way	風趣的，詼諧的









